5 7 2
3 5
1 7
1 0 0 1 0 0 1
0 0 0 0 1 0 0
1 0 0 0 0 0 1
0 0 0 0 0 1 0
0 0 0 0 1 1 0